5,1 3,1 0,0 0,0 7,1 0,0 0,0 0,0 0,0 
6,1 0,0 0,0 1,1 9,1 5,1 0,0 0,0 0,0 
0,0 9,1 8,1 0,0 0,0 0,0 0,0 6,1 0,0 
8,1 0,0 0,0 0,0 6,1 0,0 0,0 0,0 3,1 
4,1 0,0 0,0 8,1 0,0 3,1 0,0 0,0 1,1 
7,1 0,0 0,0 0,0 2,1 0,0 0,0 0,0 6,1 
0,0 6,1 0,0 0,0 0,0 0,0 2,1 8,1 0,0 
0,0 0,0 0,0 4,1 1,1 9,1 0,0 0,0 5,1 
0,0 0,0 0,0 0,0 8,1 0,0 0,0 7,1 9,1 
